433,397,397,397,397,397,397,401,397,397,397,397,390,432,432,432,432,432,432,432,432,432,432,432,432,432,432,432,432,432,432,432,
425,8,10,10,10,10,10,9,10,10,10,11,411,432,432,432,432,432,432,432,432,432,432,432,432,432,432,432,432,432,432,432,
425,21,35,35,35,35,35,35,35,35,35,37,403,432,432,432,432,432,432,432,432,432,432,432,432,432,432,432,432,432,432,432,
425,21,35,35,35,35,35,35,35,35,35,37,409,432,432,432,432,432,432,432,432,432,432,432,432,432,432,432,432,432,432,432,
425,21,35,35,35,35,35,35,35,35,35,37,403,432,432,432,432,432,432,432,432,432,432,432,432,432,432,432,432,432,432,432,
425,21,35,35,35,35,35,35,35,35,35,37,392,396,396,401,432,432,432,432,432,432,432,432,432,432,432,432,432,432,432,432,
425,47,48,48,48,48,48,48,48,48,48,45,41,197,197,197,432,432,432,432,432,432,432,432,432,432,432,432,432,432,432,432,
418,419,419,419,419,419,419,419,419,419,419,419,445,438,438,438,432,432,432,432,432,432,432,432,432,432,432,432,432,432,432,432,
432,432,432,432,432,432,432,432,432,432,432,432,432,432,432,432,432,432,432,432,432,432,432,432,432,432,432,432,432,432,432,432,
432,432,432,432,432,432,432,432,432,432,432,432,432,432,432,432,432,432,432,432,432,432,432,432,432,432,432,432,432,432,432,432,
432,432,432,432,432,432,432,432,432,432,432,432,432,432,432,432,432,432,432,432,432,432,432,432,308,432,432,432,432,432,432,432,
432,432,432,432,432,432,432,432,432,432,432,432,432,432,432,432,432,432,432,432,432,432,432,432,432,432,432,432,432,432,432,432,
432,432,432,432,432,432,432,432,432,432,432,432,432,432,432,432,432,432,432,432,432,432,432,432,432,432,432,432,432,432,432,432,
432,432,432,432,432,432,432,432,432,432,432,432,432,432,432,432,432,432,432,432,432,432,432,432,432,432,432,432,432,432,432,432,
432,432,432,432,432,432,432,432,432,432,432,432,432,432,432,432,432,432,432,432,432,432,432,432,432,432,432,432,432,432,432,432,
432,432,432,432,432,432,432,432,432,432,432,432,432,432,432,432,432,432,432,432,432,432,432,432,432,432,432,432,432,432,432,432,
432,432,432,432,432,432,432,432,432,432,432,432,432,432,432,432,432,432,432,432,432,432,432,432,432,432,432,432,432,432,432,432,
432,432,432,432,432,432,432,432,432,432,432,432,432,432,432,432,432,432,432,432,432,432,432,432,432,432,432,432,432,432,432,432,
