4,1
433,396,393,400,401,402,393,396,390,572,572,572,572,572,572,572,572,572,572,572,572,572,572,572,572,572,572,572,572,572,572,572,
391,8,10,10,10,10,10,11,403,572,572,572,572,572,572,572,572,572,572,572,572,572,572,572,572,572,572,572,572,572,572,572,
391,21,191,168,168,191,191,37,421,503,463,463,463,463,463,463,463,463,463,460,572,572,572,572,572,572,572,572,572,572,572,572,
391,21,191,191,191,168,191,37,421,461,112,114,114,114,114,114,114,114,115,491,572,572,572,572,572,572,572,572,572,572,572,572,
391,177,191,168,191,191,191,37,403,461,125,139,139,139,139,139,139,139,141,491,572,572,572,573,533,533,533,533,533,530,572,572,
391,47,48,31,191,32,48,50,421,461,125,139,139,139,139,139,139,139,141,491,572,572,572,565,60,62,62,62,63,551,572,572,
418,419,420,21,35,37,407,419,435,461,125,139,139,139,139,139,139,139,141,491,572,572,572,565,73,87,87,87,89,551,572,572,
572,572,391,21,168,37,421,572,572,461,151,152,152,152,135,139,136,152,154,491,572,572,572,565,73,87,87,87,89,551,572,572,
572,572,391,21,35,37,421,572,572,488,489,489,489,489,490,471,477,489,489,505,572,572,572,565,73,87,87,87,89,551,572,572,
572,572,391,21,35,37,392,396,393,393,396,396,393,390,424,0,411,432,572,572,572,572,572,565,73,87,87,87,89,551,572,572,
572,572,391,21,35,175,10,10,10,10,10,10,11,421,391,13,411,572,572,572,572,572,572,565,73,87,87,87,89,551,572,572,
572,572,391,21,35,35,35,35,35,35,168,35,37,392,405,13,392,393,393,393,393,393,393,545,73,87,87,87,89,551,572,572,
572,572,391,21,35,35,168,35,35,35,35,35,24,41,197,197,197,197,197,197,197,197,197,41,86,87,87,87,89,551,572,572,
572,572,391,47,48,48,48,48,48,48,48,48,50,407,419,419,419,419,419,419,419,419,419,560,73,87,87,87,89,551,572,572,
572,572,418,419,419,419,419,419,419,419,419,419,419,435,572,572,572,572,572,572,572,572,572,565,99,100,100,100,102,551,572,572,
572,572,572,572,572,572,572,572,572,572,572,572,572,572,572,572,572,572,572,572,572,572,572,558,579,579,579,579,579,575,572,572,
308,308,308,308,308,308,308,308,308,308,308,308,308,308,308,308,308,308,308,308,308,308,308,308,308,308,308,308,308,308,308,308,
308,308,308,308,308,308,308,308,308,308,308,308,308,308,308,308,308,308,308,308,308,308,308,308,308,308,308,308,308,308,308,308,



__Objects
{(2,2),type:"key",id:0}
{(15,8),type:"door",doorType:5,id:0}
{(4,0),type:"door",doorType:0,id:-1,room:"room1"}

__Props