8,10,10,10,166,10,10,10,10,10,10,10,166,10,10,11,
21,35,35,35,35,35,35,35,35,35,35,35,35,35,35,193,
21,35,35,35,35,35,35,35,35,35,35,87,77,35,35,37,
177,35,35,35,35,35,35,35,35,35,35,35,35,35,35,37,
21,35,35,35,35,35,35,35,35,77,35,87,35,35,35,37,
21,35,35,35,35,35,35,35,35,35,35,35,191,35,35,193,
21,35,35,35,35,35,35,35,35,35,35,35,35,35,35,37,
177,35,35,35,77,35,35,35,35,35,35,35,35,35,35,37,
203,48,48,48,48,48,48,48,48,48,48,48,48,48,48,50,

