5,15
432,432,432,432,432,432,432,432,432,432,432,432,432,432,573,537,537,537,537,537,537,537,537,537,537,537,530,432,432,432,432,432,
432,432,432,432,432,432,432,432,432,432,432,432,432,432,565,8,10,10,166,10,10,10,10,166,10,11,550,432,432,432,432,432,
432,432,432,432,432,432,432,432,432,432,432,432,432,432,565,177,35,35,168,35,35,168,35,35,168,193,550,432,432,432,432,432,
432,432,432,432,432,432,432,432,432,432,432,432,432,432,565,21,168,35,168,35,168,35,35,35,168,37,550,432,432,432,432,432,
432,432,432,432,432,432,432,432,432,432,432,432,432,432,565,47,204,48,48,48,205,48,48,204,48,50,550,432,432,432,432,432,
432,573,536,536,536,536,536,536,536,536,536,536,536,530,558,559,559,559,559,560,13,547,559,559,559,559,575,432,432,432,432,432,
432,564,8,10,166,10,166,10,166,10,10,166,167,550,432,432,432,432,572,564,13,550,432,432,432,432,432,432,432,432,432,432,
432,564,177,191,191,191,191,191,191,191,191,191,193,550,432,432,432,432,572,564,169,550,572,432,432,432,432,432,432,432,432,432,
432,564,21,191,168,191,191,168,191,191,191,191,37,550,432,432,432,432,572,564,169,550,572,432,432,432,432,432,432,432,432,432,
432,564,177,191,191,191,191,191,191,191,191,191,37,532,536,536,536,536,536,545,401,532,536,536,536,536,536,536,536,536,536,536,
432,564,21,191,191,191,191,168,191,168,191,191,175,10,10,10,10,10,10,10,9,10,10,10,10,10,10,10,10,10,10,10,
432,564,177,191,191,191,168,191,191,191,191,191,188,204,48,204,204,48,48,204,48,204,48,48,48,48,204,48,204,204,48,48,
432,564,21,191,191,191,191,191,191,191,168,191,193,547,578,578,578,578,578,578,578,578,578,578,578,578,578,578,578,578,578,578,
432,564,21,168,191,191,191,191,168,191,191,191,37,550,432,432,432,432,432,432,432,432,432,432,432,432,432,432,432,432,432,432,
432,564,177,191,191,191,191,191,191,191,191,191,193,550,432,432,432,432,432,432,432,432,432,432,432,432,432,432,432,432,432,432,
432,564,47,48,48,49,48,204,48,48,48,204,206,550,432,432,432,432,432,432,432,432,432,432,432,432,432,432,432,432,432,432,
432,558,578,578,578,444,578,578,578,578,578,578,578,575,432,432,432,432,432,432,432,432,432,432,432,432,432,432,432,432,432,432,
432,432,432,432,432,432,432,432,432,432,432,432,432,432,432,432,432,432,432,432,432,432,432,432,432,432,432,432,432,432,432,432,
__Objects
{(4,4),type:"key",id:0}

{(5,16),type:"door",doorType:0,id:-1,room:"example"}

__Props
{()