5,15
432,432,432,432,432,432,432,432,432,432,432,432,432,432,432,432,432,432,432,432,432,432,432,432,432,432,432,432,432,432,432,432,
432,432,432,432,432,432,432,432,432,432,432,432,432,432,432,432,432,432,432,432,432,432,432,432,432,432,432,432,432,432,432,432,
432,432,432,432,432,432,432,432,432,432,432,432,432,432,432,432,432,432,432,432,432,432,432,432,432,432,432,432,432,432,432,432,
432,432,432,432,432,432,432,432,432,432,432,432,432,432,432,432,432,432,432,432,432,432,432,432,432,432,432,432,432,432,432,432,
432,432,432,432,432,432,432,432,432,432,432,432,432,432,432,432,432,432,432,432,432,432,432,432,432,432,432,432,432,432,432,432,
432,573,536,536,536,536,536,536,536,536,536,536,536,530,432,432,432,432,432,432,432,432,432,432,432,432,432,432,432,432,432,432,
432,564,8,10,166,10,166,10,166,10,10,166,167,550,432,432,432,432,432,432,432,432,432,432,432,432,432,432,432,432,432,432,
432,564,177,191,191,191,191,191,191,191,191,191,193,550,432,432,432,432,432,432,432,432,432,432,432,432,432,432,432,432,432,432,
432,564,21,191,168,191,191,168,191,191,191,191,37,550,432,432,432,432,432,432,432,432,432,432,432,432,432,432,432,432,432,432,
432,564,177,191,191,191,191,191,191,191,191,191,37,550,432,432,432,432,432,432,432,432,432,432,432,432,432,432,432,432,432,432,
432,564,21,191,191,191,191,168,191,168,191,191,193,550,432,432,432,432,432,432,432,432,432,432,432,432,432,432,432,432,432,432,
432,564,177,191,191,191,168,191,191,191,191,191,37,550,432,432,432,432,432,432,432,432,432,432,432,432,432,432,432,432,432,432,
432,564,21,191,191,191,191,191,191,191,168,191,193,550,432,432,432,432,432,432,432,432,432,432,432,432,432,432,432,432,432,432,
432,564,21,168,191,191,191,191,168,191,191,191,37,550,432,432,432,432,432,432,432,432,432,432,432,432,432,432,432,432,432,432,
432,564,177,191,191,191,191,191,191,191,191,191,193,550,432,432,432,432,432,432,432,432,432,432,432,432,432,432,432,432,432,432,
432,564,47,48,48,49,48,204,48,48,48,204,206,550,432,432,432,432,432,432,432,432,432,432,432,432,432,432,432,432,432,432,
432,558,578,578,578,444,578,578,578,578,578,578,578,575,432,432,432,432,432,432,432,432,432,432,432,432,432,432,432,432,432,432,
432,432,432,432,432,432,432,432,432,432,432,432,432,432,432,432,432,432,432,432,432,432,432,432,432,432,432,432,432,432,432,432,
__Objects
{(4,4),type:"key",id:0}
{(5,16),type:"door",doorType:0,id:-1,room:"example"}

__Props